{
  "levelId": 5,
  "moves": 25,
  "objectives": [
    { "target": "blocker", "type": "rope", "count": 9 },
    { "target": "blocker", "type": "stone", "count": 8 }
  ],
  "gridLayout": [
    [0, 0, 0, 0, 0, 0, 0, 0, 0],
    [0, 0, 0, 0, 0, 0, 0, 0, 0],
    [0, 0, 0, 0, 0, 0, 0, 0, 0],
    [0, 0, 0, 0, 0, 0, 0, 0, 0],
    [0, 0, 0, 0, 0, 0, 0, 0, 0],
    [0, 0, 0, 0, 0, 0, 0, 0, 0],
    [0, 0, 0, 0, 0, 0, 0, 0, 0],
    [0, 0, 0, 0, 0, 0, 0, 0, 0],
    [0, 0, 0, 0, 0, 0, 0, 0, 0]
  ],
  "blockerLayout": [
    [0, 0, 0, 0, 1, 0, 0, 0, 0],
    [0, 0, 0, 1, 1, 1, 0, 0, 0],
    [0, 0, 0, 0, 1, 0, 0, 0, 0],
    [3, 3, 3, 3, 3, 3, 3, 3, 3],
    [0, 0, 0, 0, 0, 0, 0, 0, 0],
    [1, 1, 1, 0, 0, 0, 0, 0, 0],
    [1, 0, 1, 0, 0, 0, 0, 0, 0],
    [0, 0, 0, 0, 0, 0, 0, 0, 0],
    [0, 0, 0, 0, 0, 0, 0, 0, 0]
  ],
  "availableGems": ["red", "green", "blue", "purple", "yellow", "orange"]
}

