{
  "levelId": 1,
  "moves": 25,
  "objectives": [
    { "target": "gem", "type": "red", "count": 20 },
    { "target": "gem", "type": "green", "count": 15 }
  ],
  "gridLayout": [
    [1, 2, 3, 4, 1, 2, 3, 4, 1],
    [2, 3, 4, 1, 2, 3, 4, 1, 2],
    [3, 4, 1, 2, 3, 4, 1, 2, 3],
    [4, 1, 2, 3, 4, 1, 2, 3, 4],
    [1, 2, 3, 4, 1, 2, 3, 4, 1],
    [2, 3, 4, 3, 2, 3, 4, 1, 2],
    [2, 3, 3, 2, 3, 4, 1, 2, 3],
    [4, 3, 2, 3, 4, 1, 2, 3, 4],
    [1, 2, 3, 3, 1, 2, 3, 4, 1]
  ],
  "availableGems": ["red", "green", "blue", "purple"]
}
